{
"VD":"470",
"VS":"451",
"GE":"590",
"BE":"522",
"FR":"346",
"SO":"270",
"NE":"440",
"JU":"500",
"BS":"1111",
"BL":"495",
"AG":"486",
"ZH":"468",
"GL":"301",
"SH":"407",
"AR":"910",
"AI":"297",
"SG":"481",
"GR":"634",
"TG":"565",
"LU":"406",
"UR":"215",
"SZ":"195",
"OW":"215",
"NW":"204",
"ZG":"447",
"TI":"560"
}
